1111111111111
100100C0000C1
1100011111001
1P1011E0C0001
1111111111111