11111111
1000E0C1
10111111
10000001
11111101
1P000001
11111111