11111111111
10C00E000C1
10111000111
1000000C111
11110001111
1P00C011111
11111111111