11111111111111111
10C0101000000E0C1
101111000C0000111
100000000C0P0C111
1010C01000C001111
11111111111111111