11111111111111111
10C00E000000000C1
101110000C0000111
100000000C000C111
1P00C010000001111
11111111111111111