11111111
100C0001
11111001
10C00001
110CE001
111P0C11
10000001
11111111