11111111111
10000EP0001
10111111111
10CC0000111
11110001111
10000011111
11111111111